1011111111
1011111111
1000001111
1111101111
1111101111